R 1280 720

C 254,254,254
F 100,100,100

WE ./textures/walls/mario_1.XPM
EA ./textures/walls/mario_4.XPM
NO ./textures/walls/mario_2.XPM
SO ./textures/walls/mario_3.XPM
S ./textures/sprites/mario.XPM


11111111111111111111
1000001000010000000111
11000000000000000000111
10000000011101000000011
10000000000000000001111
1000001000000000E00000111111
11100011000100000000011
10000011000100000000001
11000001000100000000111111
11000000010110000011111
11011000001110000000111
111111111111111111111111




