R 1280 720

C 92,238,202
F 128,208,15

WE ./textures/walls/mario1.XPM
EA ./textures/walls/mario_4.XPM
NO ./textures/walls/mario_2.XPM
SO ./textures/walls/mario_3.XPM
S ./textures/sprites/mario.XPM


11111111111111111111
1000001000010000000111
1100000000000000000S111
10000000011101000000011
10020000000000000001111
1000001000000000000000111111
11102011000100000000011
10000011000100002000001
11000001000100200000111111
11000020010110002011111
11011000001110000000111
111111111111111111111111




