R 1280 720

C 92,148,252
F 128,208,15

WE ./textures/walls/mario_1.XPM
EA ./textures/walls/mario_4.XPM
NO ./textures/walls/mario_2.XPM
SO ./textures/walls/mario_3.XPM
S ./textures/sprites/mario.XPM

        1111111111111111111111111
        1000000000000000000000001
        1100002000000000000000001
        1000000000000000000000001
111111111000110110000020000000001
100000000000100010000001100001111
10000000000010N01000000110001
10000000000011011000000000021
10000000000000000000020000021
10000000000000000000000000001
10000000000000000001010000001
11000001110101011111011110101
11110111 1110121 101111010001
11111111 1111111 111111111111



